width = 5632
height = 2304

max_provinces	= 5658
sea_starts		= {
	1589 1592 1593 1594 1595 1596 1597 1598 1599 1600 1601 1602 1603 1604 1605 1606 1607 1608 1609  
	1610 1611 1612 1613 1614 1615 1616 1617 1618 1619 1620 1621 1622 1623 1624 1625 1626 1627 1628 1629 
	1630 1631 1632 1633 1634 1635 1636 1637 1638 1639 1640 1641 1643 1644 1645 1646 1647 1648 1649 1650 
	1651 1652 1653 1654 1655 1656 1657 1658 1659 1660 1661 1662 1664 1665 1666 1667 1668 1669 1670 1671 
	1672 1673 1674 1675 1676 1678 1679 1680 1681 1682 1683 1684 1685 1686 1687 1688 1689 1690 1691 
	1692 1693 1694 1695 1696 1698 1699 1700 1701 1702 1703 1704 1705 1706 1707 1708 1712 1713 1714 1715 
	1716 1717 1718 1719 1720 1721 1722 1723 1724 1725 1726 1727 1728 1729 1730 1731 1732 1736 1737 1738 
	1739 1740 1741 1742 1743 1744 1745 1746 1747 1748 1749 1754 1757 
	1766 1768 1769 1770 1771 1772 1773 1774 1775 1776 1777 1778 1779 1780 1782 1783 
	1784 1785 1786 1787 1788 1789 1790 1791 1792 1793 1794 1795 1796 1797 1798 1799 1800 1801 1802 1803 
	1804 1805 1806 1807 1808 1809 1810 1811 1812 1813 1814 1815 1816 1817 1818 1819 1820 1825 1826 1827 
	1828 1829 1830 1831 1832 1833 1834 1835 1836 1838 1839 1840 1841 1842 1843 1846 1847 1849 1850 
	1851 1852 1853 1854 1855 1856 1857 1860 1862 1863 1864 1866 1867 1868 1869 1870 1871 1872 1873 
	1874 1875 1876 1877 1878 1879 1880 1881 1882 1883 1884 1885 1886 1887 1888 1889 1890 1891 1892 1893 
	1894 1895 1896 1897 1898 1899 1900 1901 1902 1903 1904 1905 1906 1907 1908 1909 1910 1911 1912 1913 
	1914 1915 1916 1917 1918 1919 1922 1923 1924 1925 1926 1927 1928 1929 1930 1931 1932 1933 
	1934 1935 1936 1937 1938 1939 1940 1941 1942 1943 1944 1945 1946 1947 1948 1949 1950 1951 1952 1953 
	1954 1955 1956 1957 1958 1959 1960 1961 1962 1963 1964 1965 1966 1967 1968 1969 1970 1971 1973 1974 
	1975 1976 1977 1978 1979 1980 1981 1982 1983 1984 1985 1986 1987 1988 1989 1990 1991 1992 1993 1994 
	1995 1996 1997 1998 1999 2000 2001 2002 2003 2004 2005 2006 2007 2009 2010 2011 2012 2013 2014 
	2015 2016 2017 2018 2019 2020 2021 2022 2023 2024 2025 2026 2027 2028 2029 2030 2031 2032 2033 2034 
	2035 2036 2037 2038 2039 2040 2041 2042 2043 2044 2045 2046 2047 2048 2049 2050 2051 2052 2053 2054 
	2055 2056 2057 2058 2059 2060 2061 2062 2063 2064 2518 2519 2521 2522 2523 2524 2526 2782 2783 
	2784 4105 4106 4107 4108 4109 4313 5285 5286 5287 5288 5289 5290 5504
	4284 4285 4286 4287 4288 4289 4290 4291 4292 4293 4294 4295 4296 4297 4298 4299 4300 4301 4302 4303 
	4304 4305 4306 4307 4308 4309 4310 4311 4312 4314 4315 4316 4317 4318 4319 4320 4321 4322 4323 
	4324 4325 4326 4327 4328 4329 4330 4331 4332 4333 4334 4335 4336 4337 4338 4339 4340 4341 4342 4343 
	4344 4345 4346 4347 4348 4349 4350 4351 4352 4353 4354 4355 4356 4357 4358 

}

only_used_for_random = {
	#RNW Sea provinces
	4424 4425 4426 4427 4428 4429 4430 4431 4432 4433 4434 4435 4436 4437 4438 4439 4440 4441 4442 4443 
	4444 4445 4446 4447 4448 4449 4450 4451 4452 4453 4454 4455 4456 4457 4458 4459 4460 4461 4462 4463 
	4464 4465 4466 4467 4468 4469 4470 4471 4472 4473 4474 4475 4476 4477 4478 4479 4480 4481 4482 4483 
	4484 4485 4486 4487 4488 4489 4490 4491 4492 4493 4494 4495 4496 4497 4498 4499 4500

	#RNW - Former Trade Company feature
	4129 4130 4131 4132 4133 4134 4135 4136 4137 4138 4139 4140 4141 4142 4143 4144 4145 4146 4147 4148 
	4149 4150 4151 4152 4153 4154 4155 4156 4157 4158 4159 4160 4161 4162 4163 4164 4165 4166 4167 4168 
	4169 4170 4171 4172 4173 4174 4175 4176 4177 4178 4179 4180 4181 4182 4183
	
	#Valhalla province for feature
	5511 
	
	#Reserved for Fire submod?
	4538 4539 4541 4542 4544 4546 4553 4559 4571 4581 4582 4585 4587 4591 4611 4612 4614 4616 4617 4619 
	4620 4623 4629 4631 4632 4633 4634 4635 4636 4637 4638 4639 4640 4641 4642 4643 4644 4648 4649 4650 
	4654 4656 4657 4658 4659 4661 4662 4663 4664 4665 4666 4667 4668 4669 4670 4671 4672 4673 4675 4676 
	4677 4678 4679 4680 4681 4682 4683 4684 4685 4686 4687 4688 4689 4690 4691 4692 4693 4694 4695 4696 
	4697 4698 4699 4700 4701 4702 4703 4704 4706 4707 4708 4709 4710 4711 4712 4713 4714 4715 4716 4717 
	4718 4719 4720 4721 4722 4723 4724 4725 4726 4727 4728 4729 4730 4731 4732 4733 4734 4735 4736 4737 
	4738 4739 4740 4741 4742 4743 4744 4746 4747 4748 4749 4750 4751 4752 4753 4754 4755 4756 4757 4758 
	4759 4760 4761 4762 4763 4764 4765 4766 4767 4768 4769 4770 4771 4772 4773 4774 4775 4776 4777 4778 
	4779 4780 4781 4782 4783 4784 4785 4786 4787 4788 4789 4790 4791 4792 4793 4794 4795 4796 4797 4798 
	4799 4800 4801 4802 4803 4804 4805 4807 4808 4809 4810 4811 4812 4813 4814 4815 4817 4820 4821 4822 
	4823 4824 4825 4826 4827 4828 4829 4830 4831 4832 4833 4834 4835 4836 4837 4838 4839 4840 4841 4842 
	4843 4844 4845 4846 4847 4848 4849 4850 4851 4852 4853 4854 4855 4856 4857 4858 4859 4860 4861 4862 
	4863 4864 4865 4866 4867 4868 4869 4870 4871 4872 4873 4874 4875 4876 4877 4878 4879 4880 4881 4882 
	4883 4884 4885 4886 4887 4888 4889 4890 4891 4892 4893 4894 4895 4896 4897 4898 4899 4900 4901 4902 
	4903 4904 4905 4906 4907 4908 4909 4910 4911 4912 4913 4914 4915 4916 4917 4918 4919 4920 4921 4922 
	4923 4924 4925 4926 4927 4928 4929 4930 4931 4932 4933 4934 4935 4936 4937 4938 4939 4940 5523 5524 
	5525 5526 5527 5528 5529 5530 5531 5532 5533 5534 5535 5536 5537 5538 5539 5540 5541 5542 5543 5544 
	5545 5546 5547 5548 5549 5550 5551 5552 5553 5554 5555 5556 5557 5558 5559 5560 5561 5562 5563 5564 
	5565 5566 5567 5568 5569 5570 5571 5572 5573 5574 5575 5576 5577 5578 5579 5580 5581 5582 5583 5584 
	5585 5586 5587 5588 5589 5590 5591 5592 5593 5594 5595 5596 5597 5598 5599 5600 5601 5602 5603 5604 
	5605 5606 5607 5608 5609 5610 5611 5612 5613 5614 5615 5616 5617 5618 5619 5620 5621 5622 5623 5624 
	5625 5626 5627 5628 5629 5630 5631 5632 5633 5634 5635 5636 5637 5638 
}

lakes = {
	1677 1750 1751 1752 1753 1756 1761 1762 1763 1764 1765 1920 1921 2164 3307 3707 3708 3709 3710 5283 
	3711 3712 3713 3714 3715 3716 3717 3718 3975 3976 3978 3979 3995 3996 4359 4360 4361 4362 4363 2646 
	4364 4365 4366 4367 4368 4369 4370 4371 4372 4373 4374 4375 4376 4377 4378 4379 4380 4381 4382 4383 
	4384 4385 4386 4387 4388 4389 4390 4391 4392 4393 4394 4395 4396 4397 4398 4399 4400 4401 4402 4403 
	4404 4405 4406 4407 4408 4409 4410 4411 4412 4413 4414 4415 4416 4417 4418 4419 4420 4421 4422 4423 
	5509 5510 
}

force_coastal = {
	274 1687 1871 1875 2056 1851 1853 1856 2782 2784 1104 
}


definitions = "definition.csv"
provinces = "provinces.bmp"
positions = "positions.txt"
terrain = "terrain.bmp"
rivers = "rivers.bmp"
terrain_definition = "terrain.txt"
heightmap = "heightmap.bmp"
tree_definition = "trees.bmp"
continent = "continent.txt"
adjacencies = "adjacencies.csv"
climate = "climate.txt"
provincegroup = "provincegroup.txt"
area = "area.txt"
region = "region.txt"
superregion = "superregion.txt"
ambient_object = "ambient_object.txt"
seasons = "seasons.txt"
trade_winds = "trade_winds.txt"
canal_definition = {
	name = "panama_canal"
	x = 1317
	y = 1091
}
canal_definition = {
	name = "suez_canal"
	x = 3040
	y = 787
}
canal_definition = {
	name = "kiel_canal"
	x = 2756
	y = 337
}

# Define which indices in trees.bmp palette which should count as trees for automatic terrain assignment
tree = { 3 4 7 10 }
